---------------
---------------
---------------
---------------
---------------
---------------
---------------
-------d-------
---------------
---------------
fff--f---f--ff-
f----ff--f--f-f
fff--f-f-f--f-f
f----f--ff--f-f
fff--f---f--ff-