d---m-m-mmm-mmm
-mm---m--------
--m-mm--mm-m-m-
-m-----mmm-m-m-
--mmmm-mm-m---m
m---mm--m-mmm--
m-m-mmmm-----mm
m-m-m----mmm-m-
---mm-mm-m---m-
m-mm-----m-mmm-
m---mmmm-m----m
mmm-m----mmm---
m---m-mmmmmm--m
m-mmm-m--------
m-----mmm-mmmma
