mmmmmmmmmmmmmmm
d----------f--m
m--mmmm-----f-m
m--m--mm-----fm
m--m---m------m
m--m--mm------m
m--mmmm-------m
m------m---mm-m
m------m--mm--m
m------m-mm---m
m------mmm----m
mf-----m-mm---m
m-f----m--mm--m
m--f---m---mm-a
mmmmmmmmmmmmmmm
