-------d-------
-mmmmmmmmmmmmmm
----m-----m----
mmm-m-mmm-m-mmm
--m-m-m---m-m--
-mm-m-m-mmm-mm-
----m-m-m------
-mmmm-m-m-mmmm-
------m-m-m----
-mm-mmm-m-m-mm-
--m-m---m-m-m--
mmm-m-mmm-m-mmm
----m-----m----
mmmmmmmmmmmmmm-
-------a-------
